1111111111111111
1000000000000001
1010000000000001
1000000000000001
1000010000000001
1030000000000001
1000000000000001
1000000000000001
1000005003000001
1040000000000001
1000000000000001
1000100000000201
1000000030000001
1005000000050001
1000000000000001
1111111111111111