         ####
 #########  ##
##  $      $ #####
#   ## ##   ##...#
# #$$ $ $$#$##...#
# #   @   #   ...#
#  $# ###$$   ...#
# $  $$  $ ##....#
###$       #######
  #  #######
  ####