    ##########
#####        ####
#     #   $  #@ #
# #######$####  ###
# #    ## #  #$ ..#
# # $     #  #  #.#
# # $  #     #$ ..#
# #  ### ##     #.#
# ###  #  #  #$ ..#
# #    #  ####  #.#
# #$   $  $  #$ ..#
#    $ # $ $ #  #.#
#### $###    #$ ..#
   #    $$ ###....#
   #      ## ######
   ########