 #################
 #...   #    #   ##
##.....  $## # #$ #
#......#  $  #    #
#......#  #  # #  #
######### $  $ $  #
  #     #$##$ ##$##
 ##   $    # $    #
 #  ## ### #  ##$ #
 # $ $$     $  $  #
 # $    $##$ ######
 #######  @ ##
       ######