############ ######
#   #    # ###....#
#   $$#   @  .....#
#   # ###   # ....#
## ## ###  #  ....#
 # $ $     # # ####
 #  $ $##  #      #
#### #  #### # ## #
#  # #$   ## #    #
# $  $  # ## #   ##
# # $ $    # #   #
#  $ ## ## # #####
# $$     $$  #
## ## ### $  #
 #    # #    #
 ###### ######