############
##     ##  #
##   $   $ #
#### ## $$ #
#   $ #    #
# $$$ # ####
#   # # $ ##
#  #  #  $ #
# $# $#    #
#   ..# ####
####.. $ #@#
#.....# $# #
##....#  $ #
###..##    #
############