################
#              #
# #            #
#              #
#    #         #
# $            #
#              #
#              #
#     B  $     #
# C            #
#              #
#   #        @ #
#       $      #
#  B       B   #
#              #
################
